chrom	start	end	size	sample	clusters
chr01	1000000	5750000	4750000	2x_LOP868_398	0.932550197637832_1.14011890509313_0.935203030560595_1.07445290036985_1.02940490189048_1.24249357529921_1.09396533804061_1.13797868284328_0.978571637468799_1.05841455111472_1.14464996853652_1.00269014702917_1.27135125709814_1.2067318071947_1.11447261511589_1.34743712925688_1.05092861782714_1.08194726266957
chr01	6000000	9250000	3250000	2x_LOP868_398	1.34642050248062_1.13694378384062_1.08009720052282_1.36558443066101_1.38667807868331_1.20337613611737_1.21871690822052_1.16153612122409_1.25153297986659_1.06019639379337_1.18652614751577_1.3648120155549321
chr01	20250000	21000000	750000	2x_LOP868_398	2.5734432238817813_2.8804383048765
chr01	22500000	23250000	750000	2x_LOP868_097	2.6435044177844498_2.72965609964742
chr01	22500000	23250000	750000	2x_LOP868_1157	0.9211112076192878_0.8192956331262754
chr01	22500000	23250000	750000	2x_LOP868_1190	0.9211112076192878_0.8192956331262754
chr01	23250000	24250000	1000000	2x_LOP868_398	2.7219638357680496_2.88325123635192_2.765045101511223
chr01	24250000	26000000	1750000	2x_LOP868_488	3.41094883447572_3.06557090961548_2.99546463995936_3.18618814860801_3.40763912384866_3.49780360946406
chr01	26000000	28500000	2500000	2x_LOP868_097	0.8935056999187521_0.8432186160740235_0.8618793280252697_0.863837588261048_0.8720141330447992_1.1143429721918_0.8811747983387941_0.8897372517074128_1.23139333342517
chr01	26000000	28500000	2500000	2x_LOP868_1157	2.7886212866491222_2.7472419184766634_2.6768247040377444_2.741843761479805_2.7704919102492003_2.8574270651989044_2.6868900591518345_2.664796100266929_2.6094858130108736
chr01	26000000	28500000	2500000	2x_LOP868_1190	2.7886212866491222_2.7472419184766634_2.6768247040377444_2.741843761479805_2.7704919102492003_2.8574270651989044_2.6868900591518345_2.664796100266929_2.6094858130108736
chr01	26000000	28500000	2500000	2x_LOP868_509	0.8935056999187521_0.8432186160740235_0.8618793280252697_0.863837588261048_0.8720141330447992_0.812575786568355_0.8811747983387941_0.8897372517074128_0.918281245495625
chr01	43000000	43750000	750000	2x_LOP868_398	1.30852903986553_1.26789684976727
chr01	52750000	53500000	750000	2x_LOP868_398	3.62073013750142_3.77554554284778
chr01	54000000	56000000	2000000	2x_LOP868_398	2.92300780950337_2.9414432178869_2.99634535773041_3.12724058044274_3.26560570002313_2.895501188900501_2.86402729470835
chr01	67000000	68250000	1250000	2x_LOP868_292	2.8621062620455615_2.7519862481030177_2.752012836652625_2.951019461891347
chr01	67000000	68250000	1250000	2x_LOP868_460	2.9291667126461554_2.7519862481030177_2.87257430834809_2.951019461891347
chr02	0	2000000	2000000	2x_LOP868_097	1.0957077069766272_1.127341017962347_1.0459374093851548_1.4668572978813983_1.2769801887311132_1.1389512363267784_1.0884586588869838
chr02	0	2000000	2000000	2x_LOP868_466	1.0957077069766272_1.127341017962347_1.0459374093851548_1.4668572978813983_1.2769801887311132_1.1389512363267784_1.0884586588869838
chr02	1250000	2000000	750000	2x_LOP868_1180	2.6356714734077276_2.75975754609399
chr02	1250000	2000000	750000	2x_LOP868_1192	2.6356714734077276_2.75975754609399
chr02	2750000	4750000	2000000	2x_LOP868_1180	2.6547220471260022_2.6926505250252477_2.6434525876114945_2.684220425154058_2.3875736146753272_2.5358345468958987_2.6208337062751297
chr02	2750000	5000000	2250000	2x_LOP868_097	1.1125038879612652_1.0322642890104332_1.065717936443439_1.2503915951117377_1.2388653164747927_1.1010118336718109_1.2470156721847343_1.0482594743904672
chr02	2750000	5000000	2250000	2x_LOP868_466	1.1125038879612652_1.0322642890104332_1.065717936443439_1.2503915951117377_1.2388653164747927_1.1010118336718109_1.2470156721847343_1.0482594743904672
chr02	2750000	5750000	3000000	2x_LOP868_1192	2.6547220471260022_2.6926505250252477_2.6434525876114945_2.742192550033633_2.3875736146753272_2.5358345468958987_2.6208337062751297_2.568014405302586_2.337334302201299_2.4116209703446008_2.3658915250562407
chr02	5000000	5750000	750000	2x_LOP868_1180	2.4116209703446008_2.3658915250562407
chr04	13000000	14000000	1000000	2x_LOP868_272	3.2348146998429_3.35234930906571_2.96005818205725
chr08	49000000	49750000	750000	2x_LOP868_480	1.52419402790457_1.65093228488875
chr09	29500000	30500000	1000000	2x_LOP868_269	1.32116556464069_1.07732760383062_0.99329867812216
chr09	29750000	30500000	750000	2x_LOP868_1180	2.349274921462859_2.424150568721349
chr09	29750000	30500000	750000	2x_LOP868_1192	2.349274921462859_2.424150568721349
chr09	40000000	41000000	1000000	2x_LOP868_493	2.38536041688732_2.50508191230429_2.43460913771051
